Animal Production NQF 1	Legacy
Animal Production NQF 2	Legacy
Animal Production NQF 4	Legacy
Automotive Sales Advisor NQF 4	QCTO
Bookkeeper NQF 5	QCTO
Business Administration Services NQF 3	Legacy
Business Administration Services NQF 4	Legacy
Business Analysis NQF 6	Legacy
Business Process Outsourcing Support NQF 3	Legacy
Computer Technician NQF 5	QCTO
Contact Centre Manager NQF 5	QCTO
Design Thinking Practitioner NQF 4	QCTO
Farming NQF 1	Legacy
Farming NQF 2	Legacy
Financial Advisor NQF 6	QCTO
Fruit Packaging and Grading Processes NQF 3	Legacy
Generic Management NQF 4	Legacy
Generic Management NQF 5	Legacy
Health Care benefits Advisor NQF 5	QCTO
Information Technology: End user Computing NQF 3	Legacy
Information Technology: System Support NQF 5	Legacy
Information Technology: Systems Development NQF 4	Legacy
Insurance Claims Administrator/Assessor NQF 4	QCTO
Insurance Underwriter NQF 5	QCTO
Long term Insurance Advisor NQF 4	QCTO
Management NQF 3	Legacy
Marketing Coordinator NQF 5	QCTO
Mixed Farming Systems NQF 1	Legacy
Mixed Farming Systems NQF 2	Legacy
New Venture Creation (SMME) NQF 2	Legacy
New Venture Creation NQF 4	Legacy
Office Supervision NQF 5	QCTO
Planner NQF 5	QCTO
Plant Production NQF 1	Legacy
Plant Production NQF 2	Legacy
Plant Production NQF 3	Legacy
Plant Production NQF 4	Legacy
Project Manager NQF 5	QCTO
Quality Assurer NQF 5	QCTO
Quality Manager NQF 6	QCTO
Retail Buyer NQF 5	QCTO
Retail Manager (Retail Chain Store Manager) NQF 5	QCTO
Retail Supervisor NQF 4	QCTO
Sales Assistant NQF 3	QCTO
Service Station Assistant NQF 2	QCTO
Software Engineer NQF 6	QCTO
Software tester NQF 5	QCTO
Store Person NQF 2	QCTO
Transport Clerk NQF 4	QCTO
Visual Merchandiser NQF 3	QCTO
Occupationally Directed Educational Training and Development Practices NQF 5	Legacy
